64
m m m m m m m m m m m m m m m m m m m m m m m m m m m m m m m m m m m m m m m m m m m m m m m m m m m m m m m m m m m m m m m m
m                                   m m m m m m m m m m m m         m m m m m m m m m m m m                                   m
m                                     m m m m m m m m m m             m m m m m m m m m m                                     m
m                       m         m       m m m m m m                     m m m m m m                                         m
m                     m           m           m m             m m             m m             ╔ = = = = = = = = = = = ╗       m
m                     m                                     m     m                           ║                       ║       m
m           b _       m                                 m m         m m                       ║                 m m   ║       m
m           _ _       m                             m m                 m m                   ║                   m   ║       m
m                     m                         m m                         m m               ║                       ║       m
m                     m                       m                                 m             v                       ║       m
m       < = = = >   m                       m                 b _                 m                       2           ║       m
m                                           m       m m       _ _       m m       m           ^                     m ║       m
m                                         m           ^                 ^           m         ║         m m m       m ║       m
m                                         m           ║                 ║           m         ║                     m ║       m
m                         m m           m m           v   < = = = = >   v           m m       ║                       ║       m
m                           m           m m           m                 m           m m       ║   m m                 ║       m
m                                       m m           m m             m m           m m       ╚ = = = = >   < = = = = ╝       m
m         m                             m m                                         m m                                       m
m         m                               m                 m m m m                 m                                       m m
m                             m m         m                                         m                                       m m
m                                       m   m                                     m                                       m m m
m m m                               m m       m                                 m                                       m m m m
m m m m m                       m m             m m       m         m       m m                                       m m m m m
m m m m m m m           m m m m                     m m m             m m m               ^                           m m m m m
m m m m m m m m                                                                           v                         m m m m m m
m m m m m m m m                                                                           m                       m m m m m m m
m m m m m m m m m                                                               m           m                     m m m m m m m
m m m m m m m m m                 m m m                                 ^         m           m < >             m m m m m m m m
m m m m m m m m m                     m               m m m ^           v         m                           m m m m m m m m m
m m m m m m m m m m                   m                     ║           m                                     m m m m m m m m m
m m m m m m m m m m                   m                     v           m                 ^                 m m m m m m m m m m
m m m m m m m m m m m               m                                   m                 v               m m m m m m m m m m m
m m m m m m m m m m m               ^                 m                                   m               m m m m m m m m m m m
m m m m m m m m m m                 v                 m           ^                     m                   m m m m m m m m m m
m m m m m m m m m                                     m           ║                     m                   m m m m m m m m m m
m m m m m m m m m                           m         ^           v m m m               m                     m m m m m m m m m
m m m m m m m m             < > m           m         v                                 m m m                 m m m m m m m m m
m m m m m m m                     m           m                                                               m m m m m m m m m
m m m m m m m                       m                                                                           m m m m m m m m
m m m m m m                         ^                                                                           m m m m m m m m
m m m m m                           v               m m m             m m m                     m m m m           m m m m m m m
m m m m m                                       m m       m         m       m m             m m                       m m m m m
m m m m                                       m                                 m       m m                               m m m
m m m                                       m                                     m   m                                       m
m m                                       m                                         m         m m                             m
m m                                       m                 m m m m                 m                               m         m
m                                       m m                                         m m                             m         m
m       ╔ = = = = >   < = = = = ╗       m m           m m             m m           m m                                       m
m       ║                 m m   ║       m m           m                 m           m m           m                           m
m       ║                       ║       m m           ^   < = = = = >   ^           m m           m m                         m
m       ║ m                     ║         m           ║                 ║           m                                         m
m       ║ m       m m m         ║         m           v                 v           m                                         m
m       ║ m                     v           m       m m       b _       m m       m                                           m
m       ║           1                       m                 _ _                 m                       m   < = = = >       m
m       ║                       ^             m                                 m                       m                     m
m       ║                       ║               m m                         m m                         m                     m
m       ║                   m   ║                   m m                 m m                             m       b _           m
m       ║                 m m   ║                       m m         m m                                 m       _ _           m
m       ║                       ║                           m     m                         m           m                     m
m       ╚ = = = = = = = = = = = ╝             m m             m m             m m           m         m                       m
m                                         m m m m m m                     m m m m m m                                         m
m                                     m m m m m m m m m m             m m m m m m m m m m                                     m
m                                   m m m m m m m m m m m m         m m m m m m m m m m m m                                   m
m m m m m m m m m m m m m m m m m m m m m m m m m m m m m m m m m m m m m m m m m m m m m m m m m m m m m m m m m m m m m m m m